#######################################
# Syntax Coloring Map
#######################################
#######################################
# # Datatypes (KEYWORD1)
#######################################
Modbus	KEYWORD1
ModbusBridge	KEYWORD1
ModbusMainData	KEYWORD1
ModbusMasterRTU	KEYWORD1
ModbusMasterTCP	KEYWORD1
ModbusRTU	KEYWORD1
ModbusSlaveInMaster	KEYWORD1
ModbusSlaveRTU	KEYWORD1
ModbusSlaveTCP	KEYWORD1
ModbusTCPSlaveServer	KEYWORD1
ModbusTable	KEYWORD1
flprogModus	KEYWORD1

#######################################
# Methods and Functions (KEYWORD2)
#######################################
adressForIndex	KEYWORD2
begin	KEYWORD2
byClient	KEYWORD2
byKasCadaCloud	KEYWORD2
byRtuOverTcp	KEYWORD2
byServer	KEYWORD2
byTcp	KEYWORD2
checkModbusAddres	KEYWORD2
checkModbusRange	KEYWORD2
configDataTable	KEYWORD2
findNextStartAddres	KEYWORD2
firstReadySlave	KEYWORD2
firstTabe	KEYWORD2
firstWriteAddress	KEYWORD2
firstWriteSlave	KEYWORD2
firstWriteTable	KEYWORD2
getHost	KEYWORD2
getIp	KEYWORD2
getLastError	KEYWORD2
getMaxAdress	KEYWORD2
getMinAdress	KEYWORD2
getPort	KEYWORD2
getTimeOutTime	KEYWORD2
hasAdress	KEYWORD2
hasSlave	KEYWORD2
hasSlaveOnIndex	KEYWORD2
hasTable	KEYWORD2
hasWriteRegisters	KEYWORD2
indexForAddres	KEYWORD2
init	KEYWORD2
isInit	KEYWORD2
isReady	KEYWORD2
isSupportFunction	KEYWORD2
lastReqest	KEYWORD2
lastTable	KEYWORD2
mainData	KEYWORD2
modbusCalcCRC	KEYWORD2
mode	KEYWORD2
nextSlave	KEYWORD2
nextTable	KEYWORD2
pool	KEYWORD2
readBool	KEYWORD2
readBoolRegister	KEYWORD2
readByte	KEYWORD2
readFloat	KEYWORD2
readInteger	KEYWORD2
readLong	KEYWORD2
readRegsSize	KEYWORD2
readUnsignedLong	KEYWORD2
readWorldRegister	KEYWORD2
resetInit	KEYWORD2
resetWriteFlag	KEYWORD2
saveBool	KEYWORD2
saveByte	KEYWORD2
saveFloat	KEYWORD2
saveInteger	KEYWORD2
saveLong	KEYWORD2
saveUnsignedLong	KEYWORD2
serverAsHost	KEYWORD2
serverMode	KEYWORD2
servers	KEYWORD2
setData	KEYWORD2
setDataBitUart	KEYWORD2
setDataTable	KEYWORD2
setFloatOrder	KEYWORD2
setHost	KEYWORD2
setInit	KEYWORD2
setIntOrder	KEYWORD2
setIpAdress	KEYWORD2
setKaScadaCloudDevceId	KEYWORD2
setKaScadaCloudHost	KEYWORD2
setKaScadaCloudIp	KEYWORD2
setKaScadaCloudPort	KEYWORD2
setLastError	KEYWORD2
setLongOrder	KEYWORD2
setMode	KEYWORD2
setParityUart	KEYWORD2
setPinPeDe	KEYWORD2
setPinRxUart	KEYWORD2
setPinTxUart	KEYWORD2
setPollingPeriod	KEYWORD2
setPort	KEYWORD2
setServerAsRtuOverTcp	KEYWORD2
setServerAsTcp	KEYWORD2
setServerHost	KEYWORD2
setServerIpAdress	KEYWORD2
setServerIpAdressAsNumber	KEYWORD2
setServerMode	KEYWORD2
setServerPort	KEYWORD2
setServerSlavesSize	KEYWORD2
setSlaveAddress	KEYWORD2
setSlaves	KEYWORD2
setSlavesSize	KEYWORD2
setSlavesToServer	KEYWORD2
setSpeedUart	KEYWORD2
setStopBitUart	KEYWORD2
setTCPPort	KEYWORD2
setTCPRemoteHost	KEYWORD2
setTCPRemoteIp	KEYWORD2
setTcpPort	KEYWORD2
setTimeOutTime	KEYWORD2
setUart	KEYWORD2
setUnsignedlongOrder	KEYWORD2
slave	KEYWORD2
slaveAddres	KEYWORD2
slaveOnIndex	KEYWORD2
status	KEYWORD2
t35TimeForSpeed	KEYWORD2
tableForType	KEYWORD2
tableType	KEYWORD2
timeForSendBytes	KEYWORD2
writeRegister	KEYWORD2
writeRegsSize	KEYWORD2

#######################################
# Constants (LITERAL1)
#######################################
FLPROG_ABCD_ORDER	LITERAL1
FLPROG_AB_ORDER	LITERAL1
FLPROG_BADC_ORDER	LITERAL1
FLPROG_BA_ORDER	LITERAL1
FLPROG_CDAB_ORDER	LITERAL1
FLPROG_COIL	LITERAL1
FLPROG_DCBA_ORDER	LITERAL1
FLPROG_DISCRETE_INPUT	LITERAL1
FLPROG_HOLDING_REGISTR	LITERAL1
FLPROG_INPUT_REGISTR	LITERAL1
FLPROG_KASCADA_CLOUD_MODBUS	LITERAL1
FLPROG_MODBUS_READY	LITERAL1
FLPROG_MODBUS_WAITING_ANSWER	LITERAL1
FLPROG_MODBUS_WAITING_CONNECT_CLIENT	LITERAL1
FLPROG_MODBUS_WAITING_SENDING	LITERAL1
FLPROG_RTU_OVER_TCP_MODBUS	LITERAL1
FLPROG_TCP_MODBUS	LITERAL1